1111111111111
10010000EC001
1000P11111001
1000110000001
1111111111111